+--+--+--+
|        |
|        |
+  +--+  +
|  |  |  |
|  |  |  |
+  +  +  +
|     |  |
|     |  |
+--+--+--